NO ./textures/bluestone.png
SO ./textures/colorstone.png
WE ./textures/redbrick.png
EA ./textures/wood.png

F 220,100,255
C 225,30,132

1111111111111111111111111111
1010000000000100100001001001
1010000000000100100004444001
1000000000000111100000000001
1000000000000000000000000001
101000000004000W000001100101
1000000000000000000000000101
1111111111111111111111111111
